#################################
#..............................R#
#H######.#############.##########
S........####R.......H..........S
#
#
#
#
#
#
#
#
#
#################################
